11111111111111111111
100000CC0000CCC00E01
10000C0C000C000C0001
1000C00C0000000C0001
100C000C0000000C0001
100CCCCCC00000C00001
1001000C00000C000001
101P000C0000C0000C01
1000000C00CCCCCCCC01
11111111111111111111
